#############################################################
#...........#.................#...#.................#.......#
#######.###.#.#####.#########.#.###.###########.###.#.#.###.#
#.......#...#.#...#.#.......#.#...#.#.......#.#.#.#.#.#.#.#.#
#.###.#######.#.#.#.#.#####.#.###.#.#.#.###.#.#.#.#.#.#.#.#.#
#.#...#.....#.#.#.#.#.#.....#.#...#.#.#.#...#.#.#.#.#.#.#.#.#
#.###.#.###.#.#.#.#.#.#######.#.###.###.#.###.#.#.#.#.#.#.#.#
#...#.#...#.#.#.#.#.#.#.......#.........#.....#.#.#.#.#.#.#.#
#.#.#####.#.#.#.#.#.#.#.#####################.#.#.#.#.#.#.#.#
#.#.#...#.#.#.#.#.#.#.#.#.................#...#.#.#.#.#.#.#.#
#.#.#.#.#.#.#.#.#.#.#.#.#.#.#############.#.###.#####.#.#.#.#
#.#.#.#...#.#.#.#.#.#.#.#.#.#...........#.#.#...#.....#.#.#.#
#.#.#.#####.#.#.#.#.#.#.###.#.###.#.#####.#.#.###.#####.#.#.#
#.#.#.#...#.#.#.#.#.#.#.....#.#.#.#.#.....#.#.........#.#.#.#
#.#.#.#.#.#.#.#.#.#.#.#######.#.#.###.#################.#.#.#
#.#.#.#.#.#.....#.#.#.....#...#.#.....#.................#.#.#
#.#.#.#.#.#########.#.#.###.###.#######.#.###############.#.#
#.#.#.#.#...........#.#...#.#...........#.#.....#.....#...#.#
###.#.#.#################.#.#############.#.###.#.###.#.#.#.#
#...#.#.#.......#.........#...............#.#...#.#.#.#.#.#.#
#.#.#.#.#.#.###.#.#.#####.###################.#.#.#.#.#.#.#.#
#.#.#.#.#.#.#.#.#.#.#...#.#.......#...........#.#.#.#...#.#.#
#.#.#.#.#.#.#.#.#.#.#.###.#.#.###.#.#.#########.#.#.#####.#.#
#.#.#.#.#.#.#.#.#.#.#.#...#.#.#.#.#.#.#.#.......#.#.....#.#.#
#.#.#.#.#.#.#.#.#.#.#.#.#####.#.#.#.#.#.#.#######.#.#.###.#.#
#.#.#.#.#.#.#.#.#.#.#.........#...#.#.#.....#.....#.#.#...#.#
#.#.#.#.#.#.#.#.###.###############.#.#.#####.#####.#.#.#.#.#
#.#.#.#.#.#.#.#.....#...............#.#.#...#.#.....#.#.#.#.#
#.#.#.#.#.#.#.#.#####.###############.###.#.#.#######.#.#.#.#
#.#.#.#.#.#.#.#.#.....#...#.........#.#...#.#.#.......#.#.#.#
#.###.#.#.#.#.#.#.#######.#.#####.#.#.#.###.#.#.#####.#.#.#.#
#.....#.#.#.#...#.......#.....#...#.#...#...#.#.#...#.#.#.#.#
#.#####.#.#.#.#########.#####.#.###.#####.###.#.#.#.#.#.#.#.#
#.#...#.#.#.#.#.............#.#.#.#.#.....#...#.#.#.#.#.#.#.#
#.#.#.#.#.#.#.#.###########.###.#.#.#.###.#.###.###.#.#.###.#
#.#.#.#.#.#.#.#.#.....#...#.....#...#.#.#.#.....#...#.#.....#
#.###.#.###.#.#.#.###.#.#.###########.#.#.#######.#.#.#######
#.....#.#...#.#.#.#...#.#.............#.#.#.......#.#.#.....#
#####.#.#.#####.#.#.###.#.#############.#.###.###.###.#.###.#
#.....#.#.......#.#.#.#.#.#.........#.........#.#.#...#...#.#
#.#####.#.#######.#.#.#.###.#######.###########.#.#.#####.#.#
#.#.....#.........#...#.#...#.....#.#.....#.....#.#.#...#.#.#
###.###############.###.#.#####.#.#.#.###.#.###.#.#.#.#.#.#.#
#...#...........#.#.#...#.#...#.#.#.....#.#.#...#.#.#.#.#.#.#
#.#.#.#########.#.#.#.###.#.#.#.#.#######.#.#####.#.#.###.#.#
#.#.#.#.......#.#...#.......#.#.#.#.......#.......#.#...#.#.#
#.###.#.#####.#.#############.###.#.#######.#######.#.###.#.#
#.#...#...#.#.#.............#.....#.#.......#.......#.....#.#
#.#.#####.#.#.#############.#####.#.#.#######.#############.#
#.#.#...#.#.#...#.........#.#...#.#.#.#.....#.#.#...........#
#.#.#.###.#.#.###.#######.#.#.###.#.#.###.#.#.#.#.###.#####.#
#.#.#.......#...........#.#.#...#.#.#.....#.#.#.#.#.#.#.#.#.#
#.#.#.###################.#.#.#.#.#.#######.#.#.#.#.#.#.#.#.#
#...#...#.................#.#.#.#.#.#.....#.#.#.#.#.#.#.#.#.#
#.#####.#.###############.#.#.#.#.#.#.#####.#.#.#.#.#.#.#.#.#
#.#.....#.#.............#.#.#.#.#.#.#.......#.#.#.#.#.#.#.#.#
#.#######.#######.###.#.#.#.#.#.#.#.#########.#.#.#.#.#.###.#
#.......#.......#.#.#.#.#.#.#.#.#.#.#.........#.....#.#.....#
#######.#######.#.#.#.###.#.###.#.#.#.###############.#.#####
#...............#...#.....#...#...#...................#.....#
#############################.#.#############################
..............................#..............................
#############################################################
